22222222222
20000000002
20000000002
20000000002
20000000002
20000100002
20000000002
20000000002
20000000002
20000000002
22222222222