67777777778
34444444445
34444444445
34444444445
34444444445
34444944445
34444444445
34444444445
34444444445
34444444445
01111111112