22222222222
20000000002
20000000002
20000000002
20000200002
20002220002
20000200002
20000000002
20000000002
20000000002
22222222222